.................
....OOOOOOO......
....O.....O......
...O.O....O......
....O.....O......
.................
.................
.................
...........X.....
.................
.................
.................
