.............
.............
....O........
...O.O.......
....O........
.............
.............
.............
...........X.
..........X.X
...........X.
.............
